//MAP CONVERTED BY dmm2tgm.py THIS HEADER COMMENT PREVENTS RECONVERSION, DO NOT REMOVE
"aK" = (
/obj/structure/bonfire/dense/prelit,
/turf/open/misc/dirt/jungle,
/area/deathmatch)
"cg" = (
/obj/effect/turf_decal/weather/dirt{
	dir = 6
	},
/turf/open/water/jungle,
/area/deathmatch)
"cX" = (
/obj/structure/flora/grass/jungle/a/style_random,
/turf/open/misc/grass/jungle,
/area/deathmatch)
"dx" = (
/obj/effect/turf_decal/weather/dirt{
	dir = 8
	},
/turf/open/misc/dirt/jungle,
/area/deathmatch)
"dG" = (
/obj/effect/turf_decal/siding/wood{
	dir = 4
	},
/obj/effect/turf_decal/siding/wood{
	dir = 8
	},
/obj/effect/turf_decal/siding/wood,
/turf/open/floor/wood/large,
/area/deathmatch)
"en" = (
/obj/structure/flora/rock/pile/style_random,
/turf/open/misc/asteroid/moon,
/area/deathmatch)
"eU" = (
/obj/structure/flora/coconuts,
/turf/open/misc/grass/jungle,
/area/deathmatch)
"fy" = (
/obj/structure/flora/rock/pile/jungle/style_random,
/turf/open/misc/dirt/jungle,
/area/deathmatch)
"fV" = (
/obj/effect/landmark/deathmatch_player_spawn,
/turf/open/misc/grass/jungle,
/area/deathmatch)
"gj" = (
/obj/structure/flora/bush/jungle/b/style_random,
/turf/open/misc/grass/jungle,
/area/deathmatch)
"hq" = (
/turf/open/misc/asteroid/moon,
/area/deathmatch)
"hV" = (
/obj/effect/turf_decal/siding/wood{
	dir = 4
	},
/obj/effect/turf_decal/siding/wood,
/turf/open/floor/wood/large,
/area/deathmatch)
"iD" = (
/obj/item/food/grown/banana,
/turf/open/misc/grass/jungle,
/area/deathmatch)
"iR" = (
/obj/effect/turf_decal/weather/dirt{
	dir = 5
	},
/turf/open/misc/dirt/jungle,
/area/deathmatch)
"kt" = (
/obj/effect/decal/cleanable/dirt,
/turf/open/misc/grass/jungle,
/area/deathmatch)
"mI" = (
/obj/effect/turf_decal/siding/wood/corner{
	dir = 1
	},
/obj/effect/turf_decal/siding/wood/corner{
	dir = 8
	},
/turf/open/floor/wood/large,
/area/deathmatch)
"nX" = (
/turf/closed/indestructible/rock,
/area/deathmatch)
"oi" = (
/obj/effect/turf_decal/weather/dirt,
/obj/effect/turf_decal/weather/dirt{
	dir = 8
	},
/turf/open/misc/dirt/jungle,
/area/deathmatch)
"oD" = (
/mob/living/carbon/human/species/monkey,
/turf/open/misc/grass/jungle,
/area/deathmatch)
"oK" = (
/obj/structure/flora/bush/jungle/a/style_random,
/turf/open/misc/grass/jungle,
/area/deathmatch)
"oO" = (
/turf/open/water/jungle,
/area/deathmatch)
"oU" = (
/obj/effect/turf_decal/siding/wood{
	dir = 1
	},
/obj/effect/turf_decal/siding/wood{
	dir = 4
	},
/turf/open/floor/wood/large,
/area/deathmatch)
"qG" = (
/turf/open/misc/grass/jungle,
/area/deathmatch)
"qN" = (
/obj/effect/landmark/deathmatch_player_spawn,
/turf/open/misc/dirt/jungle,
/area/deathmatch)
"ri" = (
/turf/open/chasm/jungle,
/area/deathmatch)
"rj" = (
/obj/effect/turf_decal/weather/dirt{
	dir = 10
	},
/turf/open/water/jungle,
/area/deathmatch)
"rk" = (
/turf/open/misc/dirt/jungle,
/area/deathmatch)
"wq" = (
/obj/effect/turf_decal/siding/wood/corner,
/turf/open/chasm/jungle,
/area/deathmatch)
"wL" = (
/obj/structure/flora/tree/jungle/small/style_random,
/turf/open/misc/grass/jungle,
/area/deathmatch)
"wV" = (
/obj/effect/turf_decal/weather/dirt{
	dir = 8
	},
/obj/structure/flora/grass/jungle/b/style_random,
/turf/open/misc/dirt/jungle,
/area/deathmatch)
"xE" = (
/obj/effect/turf_decal/siding/wood/corner,
/obj/effect/turf_decal/siding/wood/corner{
	dir = 8
	},
/turf/open/floor/wood/large,
/area/deathmatch)
"ya" = (
/obj/structure/bonfire/dense/prelit,
/turf/open/misc/grass/jungle,
/area/deathmatch)
"ys" = (
/obj/effect/turf_decal/weather/dirt{
	dir = 9
	},
/turf/open/water/jungle,
/area/deathmatch)
"yt" = (
/obj/structure/flora/bush/jungle/c/style_random,
/turf/open/misc/grass/jungle,
/area/deathmatch)
"DD" = (
/obj/structure/flora/rock/style_4,
/turf/open/misc/grass/jungle,
/area/deathmatch)
"DE" = (
/obj/structure/flora/rock/pile/style_random,
/obj/structure/flora/rock/pile/style_random,
/turf/open/misc/asteroid/moon,
/area/deathmatch)
"Em" = (
/obj/effect/turf_decal/weather/dirt{
	dir = 9
	},
/obj/effect/turf_decal/weather/dirt{
	dir = 6
	},
/turf/open/water/jungle,
/area/deathmatch)
"Gc" = (
/obj/effect/turf_decal/siding/wood{
	dir = 8
	},
/obj/effect/turf_decal/siding/wood,
/turf/open/floor/wood/large,
/area/deathmatch)
"Gg" = (
/obj/effect/turf_decal/siding/wood{
	dir = 1
	},
/obj/effect/turf_decal/siding/wood{
	dir = 8
	},
/turf/open/floor/wood/large,
/area/deathmatch)
"Gm" = (
/obj/structure/flora/tree/jungle/style_random,
/turf/open/misc/grass/jungle,
/area/deathmatch)
"HX" = (
/obj/effect/turf_decal/siding/wood/corner{
	dir = 1
	},
/turf/open/floor/wood/large,
/area/deathmatch)
"It" = (
/turf/open/floor/wood/large,
/area/deathmatch)
"IR" = (
/obj/effect/turf_decal/siding/wood{
	dir = 1
	},
/obj/effect/turf_decal/siding/wood{
	dir = 4
	},
/obj/effect/turf_decal/siding/wood{
	dir = 8
	},
/turf/open/floor/wood/large,
/area/deathmatch)
"JO" = (
/obj/structure/flora/grass/jungle/a/style_random,
/obj/item/food/grown/banana,
/turf/open/misc/grass/jungle,
/area/deathmatch)
"Nw" = (
/obj/effect/turf_decal/weather/dirt{
	dir = 1
	},
/turf/open/misc/dirt/jungle,
/area/deathmatch)
"Nx" = (
/obj/effect/turf_decal/weather/dirt,
/turf/open/misc/dirt/jungle,
/area/deathmatch)
"NJ" = (
/obj/effect/turf_decal/siding/wood{
	dir = 4
	},
/obj/effect/turf_decal/siding/wood,
/obj/effect/turf_decal/siding/wood{
	dir = 1
	},
/turf/open/floor/wood/large,
/area/deathmatch)
"Ob" = (
/obj/structure/flora/rock/pile/jungle/large/style_random,
/turf/open/misc/dirt/jungle,
/area/deathmatch)
"Od" = (
/obj/effect/turf_decal/siding/wood{
	dir = 1
	},
/obj/effect/turf_decal/siding/wood{
	dir = 8
	},
/obj/effect/turf_decal/siding/wood,
/turf/open/floor/wood/large,
/area/deathmatch)
"OK" = (
/obj/structure/flora/grass/jungle/b/style_random,
/turf/open/misc/dirt/jungle,
/area/deathmatch)
"OM" = (
/obj/structure/flora/grass/jungle/b/style_random,
/turf/open/misc/grass/jungle,
/area/deathmatch)
"Qv" = (
/obj/effect/turf_decal/weather/dirt{
	dir = 8
	},
/turf/open/water/jungle,
/area/deathmatch)
"UV" = (
/obj/structure/flora/rock/style_random,
/turf/open/misc/asteroid/moon,
/area/deathmatch)
"VZ" = (
/obj/structure/flora/grass/jungle/a/style_random,
/turf/open/misc/dirt/jungle,
/area/deathmatch)
"Wy" = (
/obj/effect/turf_decal/weather/dirt{
	dir = 1
	},
/turf/open/water/jungle,
/area/deathmatch)
"WA" = (
/obj/effect/turf_decal/siding/wood/corner{
	dir = 1
	},
/turf/open/chasm/jungle,
/area/deathmatch)
"WM" = (
/obj/item/food/grown/banana/bunch,
/turf/open/misc/grass/jungle,
/area/deathmatch)
"XO" = (
/obj/effect/turf_decal/siding/wood/corner,
/turf/open/floor/wood/large,
/area/deathmatch)
"Ys" = (
/obj/effect/turf_decal/weather/dirt{
	dir = 8
	},
/obj/structure/flora/grass/jungle/a/style_random,
/turf/open/misc/dirt/jungle,
/area/deathmatch)
"YS" = (
/obj/effect/turf_decal/weather/dirt{
	dir = 5
	},
/turf/open/water/jungle,
/area/deathmatch)
"Zb" = (
/obj/structure/flora/grass/jungle/b/style_random,
/obj/effect/landmark/deathmatch_player_spawn,
/turf/open/misc/grass/jungle,
/area/deathmatch)

(1,1,1) = {"
nX
nX
nX
nX
nX
nX
nX
nX
nX
nX
nX
nX
nX
nX
nX
nX
nX
nX
nX
nX
nX
nX
nX
nX
nX
nX
nX
nX
nX
nX
nX
nX
nX
nX
nX
nX
nX
nX
"}
(2,1,1) = {"
nX
nX
nX
nX
nX
nX
nX
nX
nX
nX
nX
nX
nX
nX
nX
nX
nX
nX
nX
nX
nX
nX
nX
nX
nX
nX
nX
nX
nX
nX
nX
nX
nX
nX
nX
nX
nX
nX
"}
(3,1,1) = {"
nX
nX
nX
nX
nX
nX
nX
nX
nX
ri
ri
nX
nX
nX
en
en
UV
hq
en
en
nX
nX
nX
nX
nX
nX
hq
UV
en
en
nX
nX
nX
nX
nX
nX
nX
nX
"}
(4,1,1) = {"
nX
nX
nX
nX
nX
nX
nX
nX
ri
ri
ri
ri
hq
en
ri
ri
ri
ri
ri
ri
hq
UV
en
ri
ri
ri
ri
ri
ri
ri
hq
nX
nX
nX
nX
nX
nX
nX
"}
(5,1,1) = {"
nX
nX
nX
nX
nX
en
hq
ri
ri
ri
ri
ri
ri
ri
ri
ri
ri
ri
ri
ri
ri
ri
ri
ri
ri
ri
ri
ri
ri
ri
ri
ri
nX
nX
nX
nX
nX
nX
"}
(6,1,1) = {"
nX
nX
nX
en
en
ri
ri
ri
ri
ri
ri
ri
ri
ri
ri
ri
ri
ri
ri
ri
ri
ri
ri
ri
ri
ri
ri
ri
ri
ri
ri
ri
ri
nX
nX
nX
nX
nX
"}
(7,1,1) = {"
nX
nX
nX
ri
ri
ri
ri
ri
ri
ri
ri
ri
ri
ri
ri
ri
ri
ri
ri
ri
ri
ri
ri
ri
ri
ri
ri
ri
ri
ri
ri
ri
ri
ri
nX
nX
nX
nX
"}
(8,1,1) = {"
nX
nX
ri
ri
ri
ri
ri
ri
ri
ri
ri
ri
ri
ri
ri
ri
ri
ri
ri
ri
ri
ri
ri
ri
ri
ri
ri
ri
ri
ri
ri
ri
ri
ri
nX
nX
nX
nX
"}
(9,1,1) = {"
nX
nX
ri
ri
ri
ri
ri
ri
ri
ri
ri
ri
ri
ri
ri
ri
ri
ri
ri
ri
ri
ri
ri
ri
ri
ri
ri
ri
ri
ri
ri
ri
ri
ri
en
nX
nX
nX
"}
(10,1,1) = {"
nX
en
ri
ri
ri
ri
ri
ri
ri
ri
ri
ri
ri
ri
ri
ri
ri
ri
ri
ri
ri
ri
ri
ri
ri
ri
qG
qG
qG
ri
ri
ri
ri
ri
UV
nX
nX
nX
"}
(11,1,1) = {"
nX
UV
ri
ri
ri
ri
ri
ri
ri
ri
ri
ri
ri
ri
ri
ri
ri
ri
ri
ri
ri
ri
ri
oK
qG
qG
cX
cX
qG
qG
ri
ri
ri
ri
ri
hq
nX
nX
"}
(12,1,1) = {"
nX
en
ri
ri
ri
ri
ri
ri
ri
ri
ri
ri
ri
ri
ri
ri
ri
ri
ri
ri
ri
ri
ri
cX
qG
yt
qG
gj
fV
qG
ri
ri
ri
ri
ri
hq
nX
nX
"}
(13,1,1) = {"
nX
nX
ri
ri
ri
ri
ri
ri
ri
ri
ri
ri
ri
ri
ri
ri
ri
ri
ri
ri
ri
qG
qG
qG
oD
Gm
iD
qG
cX
cX
qG
ri
ri
ri
ri
nX
nX
nX
"}
(14,1,1) = {"
nX
nX
ri
ri
ri
ri
ri
ri
ri
ri
ri
ri
ri
ri
ri
ri
ri
ri
ri
ri
qG
OM
OM
qG
OM
OM
qG
OM
aK
OK
rk
ri
ri
ri
ri
nX
nX
nX
"}
(15,1,1) = {"
nX
nX
ri
ri
ri
ri
ri
ri
ri
ri
ri
ri
ri
ri
ri
ri
ri
ri
ri
qG
qG
OM
yt
eU
kt
qG
rk
rk
rk
rk
ri
ri
ri
ri
hq
nX
nX
nX
"}
(16,1,1) = {"
nX
nX
nX
ri
ri
ri
ri
ri
ri
ri
ri
ri
ri
ri
ri
ri
ri
ri
ri
qG
qG
wL
Zb
qG
qG
rk
rk
VZ
OK
rk
ri
ri
ri
ri
UV
nX
nX
nX
"}
(17,1,1) = {"
nX
nX
nX
ri
ri
ri
ri
ri
ri
ri
ri
ri
ri
ri
ri
ri
ri
ri
ri
qG
qG
WM
rk
Nw
VZ
rk
rk
rk
rk
rk
ri
ri
ri
ri
hq
nX
nX
nX
"}
(18,1,1) = {"
nX
nX
nX
ri
ri
ri
ri
ri
ri
ri
ri
ri
ri
ri
ri
ri
ri
ri
wq
Od
qG
OK
rk
Nw
rk
ys
Qv
rj
rk
rk
ri
ri
ri
hq
nX
nX
nX
nX
"}
(19,1,1) = {"
nX
nX
hq
ri
ri
ri
ri
ri
ri
ri
ri
ri
ri
ri
ri
ri
ri
wq
Gg
mI
Gc
OK
VZ
iR
aK
Wy
oO
cg
rk
ri
ri
ri
ri
en
nX
nX
nX
nX
"}
(20,1,1) = {"
nX
nX
UV
ri
ri
ri
ri
ri
ri
ri
ri
ri
ri
ri
ri
ri
wq
Gg
HX
It
xE
dG
rk
rk
Nw
YS
cg
rk
VZ
ri
ri
ri
ri
en
nX
nX
nX
nX
"}
(21,1,1) = {"
nX
nX
en
ri
ri
ri
ri
ri
ri
ri
ri
ri
ri
ri
ri
wq
Gg
HX
It
XO
hV
WA
ri
ri
rk
OK
rk
OK
rk
ri
ri
ri
ri
UV
nX
nX
nX
nX
"}
(22,1,1) = {"
nX
en
ri
ri
ri
ri
ri
ri
ri
ri
ri
ri
ri
ri
wq
Gg
HX
It
XO
hV
WA
ri
ri
ri
ri
ri
ri
ri
ri
ri
ri
ri
ri
en
nX
nX
nX
nX
"}
(23,1,1) = {"
nX
en
ri
ri
ri
ri
ri
ri
ri
ri
ri
ri
ri
wq
Gg
HX
It
XO
hV
WA
ri
ri
ri
ri
ri
ri
ri
ri
ri
ri
ri
ri
ri
hq
nX
nX
nX
nX
"}
(24,1,1) = {"
nX
hq
ri
ri
ri
ri
ri
ri
ri
ri
ri
ri
wq
Gg
HX
It
XO
hV
WA
ri
ri
ri
ri
ri
ri
ri
ri
ri
ri
ri
ri
ri
ri
ri
en
nX
nX
nX
"}
(25,1,1) = {"
nX
nX
ri
ri
ri
ri
ri
ri
OK
OK
Nx
rk
IR
HX
It
XO
hV
WA
ri
ri
ri
ri
ri
ri
ri
ri
ri
ri
ri
ri
ri
ri
ri
ri
DE
nX
nX
nX
"}
(26,1,1) = {"
nX
nX
ri
ri
ri
ri
ri
rk
rk
rk
Nx
rk
rk
oU
XO
hV
WA
ri
ri
ri
ri
ri
ri
ri
ri
ri
ri
ri
ri
ri
ri
ri
ri
ri
hq
nX
nX
nX
"}
(27,1,1) = {"
nX
nX
ri
ri
ri
ri
ri
OK
aK
rk
Nx
rk
rk
rk
NJ
WA
ri
ri
ri
ri
ri
ri
ri
ri
ri
ri
ri
ri
ri
ri
ri
ri
ri
ri
ri
nX
nX
nX
"}
(28,1,1) = {"
nX
nX
ri
ri
ri
ri
ri
VZ
rk
rk
fy
dx
oi
rk
rk
ri
ri
ri
ri
ri
ri
ri
ri
ri
ri
ri
ri
ri
ri
ri
ri
ri
ri
ri
ri
nX
nX
nX
"}
(29,1,1) = {"
nX
nX
ri
ri
ri
ri
ri
rk
rk
qN
rk
rk
rk
wV
Ys
ri
ri
ri
ri
ri
ri
ri
ri
ri
ri
ri
ri
ri
ri
ri
ri
ri
ri
ri
ri
nX
nX
nX
"}
(30,1,1) = {"
nX
nX
ri
ri
ri
ri
ri
ri
rk
rk
rk
rk
rk
rk
OK
ri
ri
ri
ri
ri
ri
ri
ri
ri
ri
ri
ri
ri
ri
ri
ri
ri
ri
ri
ri
ri
nX
nX
"}
(31,1,1) = {"
nX
nX
ri
ri
ri
ri
ri
ri
rk
rk
Ob
rk
Em
rk
fy
qG
qG
ri
ri
ri
ri
ri
ri
ri
ri
ri
ri
ri
ri
ri
ri
ri
ri
ri
ri
ri
nX
nX
"}
(32,1,1) = {"
nX
nX
hq
ri
ri
ri
ri
qG
fy
rk
rk
rk
rk
rk
qG
qG
OM
qG
ri
ri
ri
ri
ri
ri
ri
ri
ri
ri
ri
ri
ri
ri
ri
ri
ri
ri
nX
nX
"}
(33,1,1) = {"
nX
nX
en
ri
ri
ri
ri
OM
qG
rk
rk
rk
OM
ya
qG
JO
OM
qG
ri
ri
ri
ri
ri
ri
ri
ri
ri
ri
ri
ri
ri
ri
ri
ri
ri
ri
nX
nX
"}
(34,1,1) = {"
nX
nX
UV
ri
ri
ri
ri
cX
qG
qG
qG
qG
qG
qG
qG
fV
qG
qG
ri
ri
ri
ri
ri
ri
ri
ri
ri
ri
ri
ri
ri
ri
ri
ri
ri
hq
nX
nX
"}
(35,1,1) = {"
nX
nX
en
ri
ri
ri
ri
ri
yt
DD
kt
cX
cX
qG
Gm
oD
gj
ri
ri
ri
ri
ri
ri
ri
ri
ri
ri
ri
ri
ri
ri
ri
ri
ri
ri
en
nX
nX
"}
(36,1,1) = {"
nX
nX
en
ri
ri
ri
ri
ri
ri
ri
ri
OM
qG
qG
yt
qG
oK
ri
ri
ri
ri
ri
ri
ri
ri
ri
ri
ri
ri
ri
ri
ri
ri
ri
ri
UV
nX
nX
"}
(37,1,1) = {"
nX
nX
nX
ri
ri
ri
ri
ri
ri
ri
ri
ri
ri
ri
ri
ri
ri
ri
ri
ri
ri
ri
ri
ri
ri
ri
ri
ri
ri
ri
ri
ri
ri
ri
ri
en
nX
nX
"}
(38,1,1) = {"
nX
nX
nX
ri
ri
ri
ri
ri
ri
ri
ri
ri
ri
ri
ri
ri
ri
ri
ri
ri
ri
ri
ri
ri
ri
ri
ri
ri
ri
ri
ri
ri
ri
ri
en
nX
nX
nX
"}
(39,1,1) = {"
nX
nX
nX
nX
en
hq
ri
ri
ri
ri
ri
ri
ri
ri
ri
ri
ri
ri
ri
ri
ri
ri
ri
ri
ri
ri
ri
ri
ri
ri
ri
ri
ri
ri
hq
nX
nX
nX
"}
(40,1,1) = {"
nX
nX
nX
nX
nX
nX
nX
ri
ri
ri
ri
ri
ri
ri
ri
ri
ri
ri
ri
ri
ri
ri
ri
ri
ri
ri
ri
ri
ri
ri
ri
ri
en
en
nX
nX
nX
nX
"}
(41,1,1) = {"
nX
nX
nX
nX
nX
nX
nX
nX
nX
en
hq
ri
ri
ri
ri
ri
en
hq
nX
nX
nX
nX
en
hq
ri
ri
ri
ri
ri
ri
en
hq
nX
nX
nX
nX
nX
nX
"}
(42,1,1) = {"
nX
nX
nX
nX
nX
nX
nX
nX
nX
nX
nX
nX
nX
en
UV
en
nX
nX
nX
nX
nX
nX
nX
nX
hq
UV
en
ri
ri
ri
nX
nX
nX
nX
nX
nX
nX
nX
"}
(43,1,1) = {"
nX
nX
nX
nX
nX
nX
nX
nX
nX
nX
nX
nX
nX
nX
nX
nX
nX
nX
nX
nX
nX
nX
nX
nX
nX
nX
nX
nX
nX
nX
nX
nX
nX
nX
nX
nX
nX
nX
"}
(44,1,1) = {"
nX
nX
nX
nX
nX
nX
nX
nX
nX
nX
nX
nX
nX
nX
nX
nX
nX
nX
nX
nX
nX
nX
nX
nX
nX
nX
nX
nX
nX
nX
nX
nX
nX
nX
nX
nX
nX
nX
"}
